0 0 0 0 0 0 0 0 0 0 0 0 0 0 0 0 0 0 0 0 0 0 0 0 0 0 0 0 0 0 0 0 0 0 0 0 0 0 0 0 0 0 0 0 0 0 0 0 0 0
0 1 1 1 1 1 4 4 4 4 4 4 4 4 4 4 1 1 1 1 1 1 1 1 1 1 1 1 1 1 1 1 1 1 1 1 1 1 1 1 1 1 1 1 1 1 1 1 1 0
0 1 1 3 3 3 3 3 3 3 3 3 3 3 3 3 3 3 3 1 1 1 1 1 1 1 1 1 1 1 1 1 1 1 1 1 1 1 1 1 1 1 1 1 1 1 1 1 1 0
0 1 1 3 6 6 5 5 5 5 5 5 5 5 5 5 6 6 3 1 1 1 1 1 1 1 1 1 1 1 1 1 1 1 1 1 1 1 1 1 1 1 1 1 1 1 1 1 1 0
0 1 1 3 6 1 1 1 1 1 1 1 1 1 1 1 1 6 3 1 1 1 1 1 1 1 1 1 1 1 1 1 1 1 1 1 1 1 1 1 1 1 1 1 1 1 1 1 1 0
0 1 1 3 6 1 1 1 1 1 1 1 1 1 1 1 1 6 3 1 1 1 1 1 1 1 1 1 1 1 1 1 1 1 1 1 1 1 1 1 1 1 1 1 1 1 1 1 1 0
0 1 1 3 6 1 1 1 1 1 1 1 1 1 1 1 1 6 3 1 1 1 1 1 1 1 1 1 1 1 1 3 1 1 1 1 1 1 1 1 1 1 1 1 1 1 1 1 1 0
0 1 1 3 6 1 1 1 1 1 11 1 1 1 1 1 1 6 3 1 1 1 1 1 1 1 1 1 1 1 1 3 3 3 3 3 3 3 3 3 3 3 3 3 3 1 1 1 1 0
0 1 1 3 6 1 1 1 1 1 1 1 1 1 1 1 1 6 3 1 1 1 1 1 1 1 1 1 1 1 1 1 1 1 1 1 1 1 1 3 1 1 1 1 1 1 1 1 1 0
0 1 1 3 6 1 1 1 1 1 1 1 1 1 1 1 1 6 3 1 1 1 1 1 1 1 1 1 1 1 1 1 1 1 1 1 1 1 1 3 1 1 1 1 1 1 1 1 1 0
0 1 1 3 6 1 1 1 1 1 1 1 1 1 1 1 1 6 3 1 1 1 1 1 1 1 1 1 1 1 1 1 1 1 1 1 1 1 1 3 1 1 1 1 1 1 1 1 1 0
0 1 3 3 6 6 6 6 6 6 6 6 6 6 6 6 6 6 3 1 1 1 1 1 1 1 1 1 1 1 1 1 1 1 1 1 1 1 1 3 1 1 1 1 1 1 1 1 1 0
0 1 3 3 3 3 3 3 3 3 3 3 3 3 3 3 3 3 3 1 1 1 1 1 1 1 1 1 1 1 1 1 1 1 1 1 1 1 1 3 1 1 1 1 1 1 1 1 1 0
0 1 3 9 1 2 1 2 1 2 9 3 8 8 8 8 8 8 3 1 1 1 1 1 1 1 1 3 3 3 3 3 1 1 1 1 1 1 3 3 1 1 1 1 1 1 1 1 1 0
0 1 3 1 1 1 1 1 1 1 1 3 8 1 1 1 1 1 3 1 1 1 1 1 1 3 3 3 1 1 1 3 3 3 3 1 3 3 3 3 1 1 1 1 1 1 1 1 1 0
0 1 3 2 1 1 1 1 1 1 2 3 8 1 1 1 1 1 3 3 3 3 3 3 3 3 3 1 1 1 1 1 1 1 3 3 3 1 1 3 1 1 1 1 1 1 1 1 1 0
0 1 3 1 1 1 1 1 1 1 1 3 8 1 1 1 1 1 1 1 1 1 8 3 1 1 1 1 1 1 1 1 1 1 1 1 1 1 1 3 1 1 1 1 1 1 1 1 1 0
0 1 3 2 1 1 1 1 1 1 2 3 8 1 1 1 1 1 1 1 1 1 8 3 1 1 1 1 1 1 1 1 1 1 1 1 1 1 1 3 1 1 1 1 1 1 1 1 1 0
0 1 3 3 3 3 3 3 1 1 1 3 8 1 1 1 1 1 1 1 1 1 8 3 1 1 1 1 1 1 1 1 1 1 1 1 1 1 1 3 1 1 1 1 1 1 1 1 1 0
0 2 2 2 2 2 2 3 9 1 9 3 4 4 4 4 4 4 4 4 4 4 8 3 1 1 1 1 1 1 1 1 1 1 1 1 1 1 1 3 1 1 1 1 1 1 1 1 1 0
0 2 2 2 2 2 2 3 3 3 3 3 3 3 3 3 3 3 3 3 3 3 3 3 3 3 3 1 1 1 1 1 1 1 1 1 1 1 1 3 1 1 1 1 1 1 1 1 1 0
0 2 2 2 2 2 2 3 3 2 2 2 2 2 2 2 2 2 2 2 3 3 2 3 3 1 1 1 1 1 1 1 1 1 1 1 1 1 1 3 1 1 1 1 1 1 1 1 1 0
0 2 3 3 3 3 3 3 3 2 2 2 2 2 2 2 2 2 2 2 3 3 2 3 3 3 1 1 1 1 1 1 1 1 1 1 1 1 1 3 1 1 1 1 1 1 1 1 1 0
0 2 3 3 8 6 6 8 3 2 2 2 2 2 2 2 2 2 2 2 2 2 2 3 1 1 1 1 1 1 1 1 1 1 1 1 1 1 1 3 1 1 1 1 1 1 1 1 1 0
0 2 3 3 6 1 1 6 3 2 2 2 2 2 2 2 2 2 2 2 2 2 2 3 1 1 1 1 1 1 1 1 1 1 1 1 1 1 1 3 1 1 1 1 1 1 1 1 1 0
0 2 3 3 8 1 1 8 3 2 2 2 2 2 2 2 2 2 2 2 2 2 2 3 1 1 1 1 1 1 1 1 1 1 1 1 1 1 1 3 1 1 1 1 1 1 1 1 1 0
0 2 3 3 6 1 1 6 3 3 3 2 2 2 2 2 2 2 2 2 2 2 2 3 1 1 1 1 1 1 1 1 1 1 1 1 1 1 1 3 1 1 1 1 1 1 1 1 1 0
0 2 3 3 8 1 1 8 6 3 3 2 2 2 2 2 2 2 2 2 2 2 2 3 1 1 1 1 1 1 1 1 1 1 1 1 1 1 1 3 1 1 1 1 1 1 1 1 1 0
0 2 3 3 6 1 1 1 8 3 3 2 2 2 2 2 2 2 2 2 2 2 2 3 3 3 1 1 1 1 1 1 1 1 1 1 1 1 1 3 3 3 3 3 3 3 3 3 11 0
0 2 3 3 6 1 1 1 1 8 3 3 3 3 3 3 3 3 3 3 3 3 3 3 3 3 3 4 4 4 4 4 1 1 1 1 1 1 1 3 2 2 2 2 3 2 2 2 2 0
0 2 3 3 8 6 1 1 1 6 3 8 2 8 2 8 2 8 2 8 2 8 2 8 3 6 3 3 3 3 10 3 3 3 3 3 3 3 3 3 2 2 2 2 3 2 2 2 2 0
0 2 3 3 3 6 1 1 1 8 3 2 8 2 8 2 8 2 8 2 8 2 8 2 3 6 3 5 5 5 5 1 1 1 1 3 2 2 2 2 2 2 2 2 3 2 2 2 2 0
0 2 1 2 3 8 1 1 1 6 3 8 2 8 2 8 2 8 2 8 2 8 2 8 3 3 3 1 1 1 1 1 1 1 1 3 2 2 2 2 2 2 2 2 3 2 2 2 2 0
0 1 2 1 3 6 1 1 1 8 3 2 8 2 8 2 8 2 8 2 8 2 8 2 3 1 3 1 1 1 1 1 1 1 1 3 2 2 2 2 2 2 2 2 3 2 2 2 2 0
0 2 1 2 3 8 1 1 1 6 3 8 2 8 2 8 2 8 2 8 2 8 2 8 3 1 3 1 1 1 1 1 1 1 1 3 2 2 2 2 2 2 2 2 3 2 2 2 2 0
0 1 2 1 3 6 1 1 1 8 3 3 3 3 3 3 3 3 3 3 3 3 3 3 3 1 3 1 1 1 1 1 1 1 1 3 2 2 2 2 2 2 2 2 3 2 2 2 2 0
0 2 1 2 3 8 6 8 8 6 3 6 1 6 1 6 1 6 1 5 5 5 5 3 1 1 3 1 1 1 1 1 1 1 1 3 2 2 2 2 2 2 2 2 3 2 2 2 2 0
0 1 2 1 3 3 6 6 6 8 3 1 6 1 6 1 6 1 6 1 6 1 6 3 1 1 3 3 3 3 3 3 3 3 3 3 2 2 2 2 2 2 2 2 3 2 2 2 2 0
0 2 1 2 3 3 6 6 3 3 3 6 1 6 1 6 1 6 1 6 1 6 1 3 1 1 1 1 1 1 1 1 1 1 1 3 2 2 2 2 2 2 2 2 3 2 2 2 2 0
0 1 2 1 1 3 3 3 3 3 6 1 6 1 6 1 6 1 6 1 6 1 6 3 1 1 1 1 1 1 1 1 1 1 1 3 3 3 3 3 3 3 3 2 3 2 2 2 2 0
0 2 1 2 1 3 1 6 1 6 1 6 1 6 1 6 1 6 1 6 1 6 1 3 3 1 1 1 1 1 1 1 1 1 1 3 1 1 12 3 2 2 3 2 3 2 2 2 2 0
0 1 2 1 1 3 6 1 6 1 6 1 6 1 6 1 6 1 6 1 6 1 6 3 3 1 1 1 1 1 1 1 1 1 1 3 1 1 1 3 2 2 3 3 3 2 2 2 2 0
0 2 1 2 1 3 1 6 1 6 1 6 1 6 1 6 1 6 1 6 1 6 1 3 3 1 1 1 1 1 1 1 1 1 1 3 1 1 1 3 2 2 2 2 2 2 2 2 2 0
0 1 2 1 1 3 6 1 6 1 6 1 6 1 6 1 6 1 6 1 6 1 6 1 3 1 1 1 1 1 1 1 1 1 1 3 1 1 1 3 2 2 2 2 2 2 2 2 2 0
0 2 1 2 1 3 1 6 1 6 1 6 1 3 3 3 3 3 3 3 3 3 3 3 3 1 1 1 1 1 1 1 1 1 1 3 1 1 1 3 2 2 2 2 2 2 2 2 2 0
0 1 2 1 1 3 6 1 6 1 6 1 6 3 2 2 2 2 3 2 2 2 2 2 3 1 1 1 1 1 1 1 1 1 1 3 1 1 1 3 2 2 2 2 2 2 2 2 2 0
0 2 1 2 1 3 4 4 4 4 4 4 4 3 2 2 2 2 3 2 2 2 2 2 3 1 1 1 1 1 1 1 1 1 1 3 3 3 3 3 2 2 2 2 2 2 2 2 2 0
0 1 2 1 1 3 3 3 3 3 3 3 3 3 3 3 3 3 3 3 3 3 3 3 3 1 1 1 1 1 1 1 1 1 1 3 8 8 7 2 2 2 2 2 2 2 2 2 2 0
0 1 1 1 1 1 5 5 5 5 5 5 5 1 1 1 1 1 1 1 1 1 1 1 1 1 1 1 1 1 1 1 1 1 1 7 8 8 8 2 2 2 2 2 2 2 2 2 2 0
0 0 0 0 0 0 0 0 0 0 0 0 0 0 0 0 0 0 0 0 0 0 0 0 0 0 0 0 0 0 0 0 0 0 0 0 0 0 0 0 0 0 0 0 0 0 0 0 0 0